1111111111111111111111111111111111
1E0000000000000F00000I000G00000001
1010010100100000101001000000010101
1010010010101010001001000000010101
1P0000000D00C0000400000000000000H1
1111111111111111111111111111111111
